-- HUBS
"GRU"	"SAO"	"Aeroporto Internacional de São Paulo/Guarulhos"
"JFK"	"NYC"	"Aeroporto Internacional John F. Kennedy"

-- BRASIL
"BSB"	"BSB"	"Aeroporto Internacional de Brasília"
"GIG"	"RIO"	"Aeroporto Internacional Tom Jobim"

"SDU"	"RIO"	"Aeroporto Santos Dumont"
"CWB"	"CWB"	"Aeroporto Internacional Afonso Pena"
"PLU"	"BHZ"	"Aeroporto de Belo Horizonte"


"FLN"	"FLN"	"Aeroporto Internacional de Florianópolis"
"SSA"	"SSA"	"Aeroporto Internacional de Salvador"
"FOR"	"FOR"	"Aeroporto Internacional de Fortaleza"
"LDB"	"LDB"	"Aeroporto de Londrina"
"CGH"	"SAO"	"Aeroporto de São Paulo/Congonhas"

-- LATAM
"EZE"	"BUE"	"Aeroporto Internacional Ministro Pistarini"
"SCL"	"SCL"	"Aeroporto Internacional Arturo Merino Benítez"
"MEX"	"MEX"	"Aeroporto Internacional da Cidade do México"

"GDL"	"GDL"	"Aeroporto Internacional de Guadalajara"


-- EUA
"DCA"	"WAS"	"Aeroporto Nacional Ronald Reagan de Washington"
"ATL"	"ATL"	"Aeroporto Internacional Hartsfield-Jackson Atlanta"
"DEN"	"DEN"	"Aeroporto Internacional de Denver"

-- EUROPA
"LHR"	"LON"	"Aeroporto de Londres Heathrow"
"HDL"	"LIS"	"Aeroporto Humberto Delgado"
"CDG"	"PAR"	"Aeroporto de Paris-Charles de Gaulle"



-- ORIENTE MÉDIO
"DXB"	"DXB"	"Aeroporto Internacional de Dubai"

-- LESTE ASIÁTICO
"HND"	"TYO"	"Aeroporto Haneda"
